#####################################################################################################
#S#  *****#*****#***#       #        *******#  *******#    ***#        *********#  *********#*****# #
#*# #*###*#*###*#*#*##### ### #######*#####*###*#####*#####*#*# #######*#######*###*#######*#*###*# #
#*# #*#***#*# #*#*#*****#   # #*****#*****#*****#   #*#*****#*#       #*****#  *****#*****#*#***#*# #
#*###*#*###*# #*#*#####*### # #*###*#####*####### # #*#*#####*####### #####*#########*###*#*###*#*# #
#***#*#*****#***#*****#***#   #***#*#***#*****#   # #***#   #***#         #***#   #***#***#*****#*# #
###*#*#######*##### #*###*#######*#*#*#*#####*# ### ##### #####*# ######### #*# ###*###*#########*# #
#***#*****# #*****# #*# #*****#***#***#*******# # # #   #   #***#   #*****# #*#***#*#***#***    #*# #
#*##### #*# #####*###*# #####*#*############### # # # # # # #*#######*###*###*#*#*#*#*# #*#*### #*# #
#*#***# #*#     #*****#     #***#   #           # #   # # # #*******#*# #*****#*#*#*#*# #*#*#   #*# #
#*#*#*# #*# ########### ######### ### ##### ##### ##### ### #######*#*# #######*#*#*#*###*#*### #*# #
#***#*# #*# #     #     #       #   # #   # # #   #   #           #***#     # #*#***#*****#***# #*# #
#####*###*# # ### # ### # ##### # # # # ### # # # # # # ######### ##### ### # #*#############*###*# #
#   #*****# # # # #   # # #   #   # # #   # #   # # #   #   #   # #       #   #*#           #***#*# #
# # ####### # # # ### # # ### ##### # ### # ##### # ##### # # # # ####### #####*# ##### #######*#*# #
# #   #     #   # #   #       #     #   # #     #   #     # # # # #     #     #*# #*****#*******#*# #
# ##### # # ### # # ########### ### ### # ##### ##### ##### # # # # ### ##### #*###*###*#*#######*# #
#   #   # #   # #   # #         #   # # #     #     #   #   # # #   # #       #***#*#  *#*********# #
### # ### ##### ##### # ######### ### # ### # ##### ### # ### ####### # #########*#*###*########### #
#   # # #     #   #   # #             # #   #     #     # #         #   #***#*****#***#*****#       #
# ### # ##### ### # # # # ########### # # ######### ##### # ##### ### ###*#*#*#######*#####*# ##### #
#   #   #   # #   # # # # #       #   # # #       # #     # #   #   # #***#***#*******#***#*#   #   #
# # ### # # # # ##### # ### ##### ##### # # ##### # # ####### # # # # #*#######*#######*#*#*##### # #
# #     # # # # #     #     #   # #       #     # # #         # # #   #*********#     #*#***#     # #
######### # # # # # ########### # # ######### # # # ########### ### ############# #####*##### ##### #
#       # #   # # #             #   # #     # # # #   #       #   # #*****************#***#   #     #
# ##### # ### # # ####### ##### ##### # ### # # # ### # ### ##### # #*###############*###*# ####### #
# #   #   #   # #       #   # # #     # # # # # # # # # #   #   # # #*#       #*******#***#       # #
# # # ##### ### ##### ##### # # ### ### # # ### # # # # ##### # # # #*####### #*#######*### ##### ###
#   # #       #   #   #     # #   #   # # #     # #   #   #   #   # #*******# #*********#   #   #   #
##### ####### ### ##### ##### ### ### # # ####### # ##### # ####### #######*# ############# # ##### #
#   # #   #   #   #     #             # #       # #   #   #     # # #     #*********#  ***#   #*****#
# # # # # ##### ### # ################# ####### # ### # ##### # # # ##### #########*# #*#*#####*###*#
# #   # #   #   #   # #           #   #       #     #   #   # # # #         #*******# #*#*#*****# #*#
# ##### ### # ##### # # ######### # # ####### ##### # ### # # # # ##### #####*####### #*#*#*##### #*#
# #     #   #     # # #   #         #       #   # # # #   # # # #     # #*****#  ***# #*#***# #***#*#
# # ##### # ##### # ##### ################# # # # # ### ### ### ### # # #*#######*#*###*##### #*#*#*#
#     #   # # #   # #   #       #   #     # # # #       # #   #   # #   #*******#*#*#***#     #*#***#
# ##### ### # # ### # # ####### # # ### ### # # ######### ### ### # ###########*#*#*#*### #####*#####
# # #   # #   # #   # #     # #   #   #   # # #   # #       #     # #   #     #*#*#***#*********#   #
# # # ### ### # ### # ### # # ####### # # # ##### # # ### ######### # # # ### #*#*#####*######### # #
#   # #   #   #   #   # # #     #     # # #   #   # # # #       #   # #   # # #*#*#*****#     #   # #
##### ### # ##### ### # # ##### # ##### # ### # ### # # ####### # ### ##### # #*#*#*##### # ### # ###
#     #   #     #   # # #   # # # #     #   #   #   #   #     #   #   #     # #***#***#   #     #   #
# ##### ### ####### # # ### # # # ####### ######### ### # ### ##### ### # ### #######*####### ##### #
# # #       #     # #     # #   # #     #           #   # # #   #   #   # #     #   #*******# #*****#
# # # ####### # ### ##### # ##### # ### # ####### # # ### # # # # ##### ### ### # #########*###*###*#
# #     #   # #     # #   #     #     # #   #   # # # #     # # # #     #   # # #         #***#***#*#
# ####### # # ####### # ####### ####### ### # # # ### ####### # # # # ### ### # # # ##### ###*###*#*#
#         # #       #         # #       #   # #   #   #     # # # # #   # # #   # #   # #   #*****#*#
# ######### ####### # ######### # ######### # ### # ### ### # # # ##### # # # ### ### # ### #######*#
# #     # # #       # # #   #   #         # #   # # #   # #   # #       # # #   # #   #     #***#***#
# # # # # # # ####### # # # # # ######### ##### ### ### # ##### ####### # # ### ### ##### ###*#*#*###
# # # #   # # #     # # # #   #         # #     #   #   #     # # #     # #   #     #***#   #*#*#***#
# ### ### # # ### # # # # ############# # # # ### ### ### ##### # # ##### # # # #####*#*#####*#*###*#
#     # # #   #   # # # # # #   #       # # # #   #   #   #     # # #     # # # #*****#*******#*****#
####### # ##### ### # # # # # # # ####### # ### ##### # # # ##### # # ####### # #*###################
# #       #   # #   # # # #   #   # #     #   # #     # # #     # # #     #   # #***#***#*****#*****#
# # ####### # # ##### # # ### ##### # ##### # # # ##### # ##### # # ##### # ### ###*#*#*#*###*#*###*#
# # #       # #         #   #       #   #   # #   #     #   #   #       # #     #***#*#*#*#  *#***#*#
# # # ### ### ############# ######### # ##### ##### ##### # # ########### ##### #*###*#*#*###*###*#*#
#   # #   # # #     #     # #       # # #   #     #   #   # # #           #***# #***#*#*#***#***#*#*#
# ### # ### # # ### # ### # # ##### # # # # ### # ### # ##### ### # ##### #*#*# ###*#*#*# #*###*#*#*#
#   # # #   #   #   # #     # #     # #   #   # #     #   #       # #***# #*#*#   #***#*# #*# #***#*#
### # # # ####### ### # ##### # ##### ####### # ####### # # #########*#*###*#*### #####*###*# #####*#
#   # # #         #   # #     #     #       # #   #***# #     #*****#*#*****#***#     #*****#   #***#
# ### # ### ######### # # ######### ######### #####*#*#########*###*#*#########*##### ####### # #*###
# #   #   #   #       # # #       #     #     #*****#*********#*# #***#   #*****#   # #     # # #*# #
# ####### ### # ####### # ####### ##### # ### #*#############*#*# ####### #*##### # # # ### # # #*# #
#         # #   #       # #           # #   # #***#  *****# #***# #       #*# #   #     #     # #***#
########### ##### ####### # ########### # # #####*###*###*# ##### # # #####*# # ###################*#
#     #                 # #             # #     #*****# #*#*****#   # #*****#       #***************#
### # # ################# # ############# ### # ####### #*#*###*### # #*##### #######*###############
#   # #     #       #     # #             #   #     #*****#*#  ***# # #*#     #***#***#   #         #
# # ##### ### ##### # ##### ########### ### ### #####*#####*#####*### #*#######*#*#*### ### ##### ###
# # #     #   #   #   #   #   #       # # #   # #*****#***#*****#*****#*******#*#***#           #   #
# ### ##### ##### ##### # ### # ##### # # ### # #*#####*#*#####*#####*#######*#*####### ########### #
#   # #   # #       #   #     # # #   # #   # # #*#    *#*****#***# #*  #***#*#*******#   # #   #   #
# # # # # # # ####### ######### # # ### ### # # #*#####*#####*###*# #*###*#*#*#######*### # # # # ###
# #     # # #       # #         # # #       # # #*#*****#   #*#***# #*#***#***  #*****#     # # #   #
########### ####### # # ######### # # ####### ###*#*##### # #*#*### #*#*#########*########### # ### #
#           #     # #   #   #     # # #     #   #***#     # #***#   #*#***********#           #     #
# ########### ### # ##### # # ### # ### ### ### ####### # # ####### #*############### ############# #
#       #     #     #     # # #   #   # # #   #       # # #   #***  #*#  ***********# #         # # #
####### # # # ####### ##### # # ##### # # ### ### ### # # ### #*#*###*###*#########*# # ####### # # #
#       # # # #       #   #   #   #   # #       # #   # # #   #*#*****#***#   #*****#         # # # #
# ####### # # # ####### # ####### # ### ####### # ### ### # ###*#######*### ###*############# # # # #
# # #     # # # #     # # #       #   #       # #   #     #   #***#***#***#   #*#*********# # # #   #
# # # ##### ### # ### # # # ######### ##### # # ### ######### ###*#*#*###*### #*#*#######*# # # ### #
# #       #     # # # # # #         #     # # #     #       #   #*#*#***#***# #***#     #*#   #   # #
# ############### # # # # # ####### ##### ### ##### # ##### ### #*#*###*###*# ##### #####*####### ###
# #     #         # #   # #       #     # #   #     #   #   # # #*#***#*****#     #*******#*****#   #
# # ### # ######### ##### ### ##### ### # # ### ##### ### ### # #*###*### ##### # #*#######*###*### #
#   #   #     #         #   # #   #   #     #   #     #   #     #*#***#   #***# # #*********# #*****#
##### # ##### # ####### ### ### # ############### ##### ### #####*#*# #####*#*# ############# #####*#
#     #   #   # #         # #   #             #   #     # # # #***#*# #*****#*# #                 #*#
# ### ##### ### # ####### # # ############### # ### ##### # # #*###*###*#####*# # ### ######### ###*#
#   # #   #   # # #     # # # #         # #   #   #   #       #*#  *****#*****# # #   #       # #***#
# # ### # ### ### # ##### # # # ####### # # ##### ### #########*#########*##### # # ### ##### ###*###
# #     #         #       #     #         #         #          ***********#       #         #    **E#
#####################################################################################################
