###############
#S**      #   #
###*### ### # #
#***#   #   # #
#*##### ##### #
#*****#   #   #
# ###*# ### ###
# #***# #   # #
# #*### # ### #
# #*# # # #***#
###*# # # #*#*#
#***#   # #*#*#
#*####### #*#*#
#***********#E#
###############
